##############
#  #.    # . #
# x#    x    #
#    ##  ##  #
#    # s  #  #
#  x  .   #  #
#            #
##############